%%%%%%%%%%%%%%%%%%%
%G.       G   ....%
%.% % %%%%%% %.%%.%
%.%o% %   o% %.o%.%
%.%%%.%  F%% %..%.%
%.....  P    %..%G%
%%%%%%%%%%%%%%%%%%%%
