%%%%%%%%%%%%%%%%%%%%
%.......%%%F%......%
%%%%%%%%..%F.......%
%......%...%%..%%%%%
%%..%.FF....%%%%%..%
%%%%..%%...%%%%%%..%
%..P%%%%...........%
%......%%%%%%%.....%
%..%..%%%%%.....%%%%
%....%......G.....F%
%%..G.FF%..........%
%...%%F%%...F%%....%
%...%......%%%%....%
%%..%.......G......%
%%%%%%%%%%%%%%%%%%%%