%%%%%%%%%%%%%%%%%%%%
%.%.....%..%....GG.%
%.......F.....%....%
%FF%...%%%%%..%%...%
%....%%%%..%%%%%...%
%%%%%%...%%%%%%%..%%
%FF%..P....%%...%%%%
%...%%%%%..%%%..%..%
%......%..%...%...%%
%......%..F%.......%
%..G.%.%...........%
%%......F...%..%...%
%..%.....F.....%%%%%
%.....F...%.....%..%
%%%%%%%%%%%%%%%%%%%%