%%%%%%%%%%%%%%%%%%%%
%...%%....%...%....%
%....%.....%....%%%%
%.....%....G...%..%
%%%%...%..FFFFF....%
%..%....%%%..%....%%
%%%..%....F...%...%%
%%%%..%....%...G..%%
%G....%......%%%%..%
%...P...%...%......%
%....%......%......%
%%.................%
%%...%%F......F%%..%
%.....%%%%%..%%%F..%
%%%%%%%%%%%%%%%%%%%%