%%%%%%%%%%%%%%%%%%%%
%%..FF..%%..F%%%...%
%...%%%%%..%G....%%%
%...%..F....P......%
%..................%
%%%%..FF..%...%....%
%%%F%%%%....%......%
%...%..%%FF%.....%%%
%......%%..%.......%
%%%%...G%..%....%..%
%%F%.......%%%%....%
%%%%%...%%.....%..%%
%.......G....%...%%%
%.F..%%%%F.....%%%%%
%%%%%%%%%%%%%%%%%%%%