%%%%%%%%%%%%%%%%%%%%
%o...%.....FF.%....%
%.%%.%.%%%%%%.%.%%.%
%.%..............%.%
%.%.%%.%%  %%.%%.%.%
%......%G  G%......%
%.%.%%.F%%%%%.%%.%.%
%.%...GG.........%.%
%.%%.%.%%%%%%.%.%%.%
%....%...P....%...o%
%o...%.....F..%....%
%.%%.%.%%%%%%.%.%%.%
%.%....F.........%.%
%.%.%%.%%  %%.%%.%.%
%..F...%.  .%...FF.%
%.%.%%.%%%%%%.%%.%.%
%.%..............%.%
%.%%.%.%%%%%%.%.%%.%
%....%........%...o%
%%%%%%%%%%%%%%%%%%%%
