%%%%%%%%%%%%%%%%%%%%
%o...%.....F..%....%
%.%%.%.%%%%%%.%.%%.%
%.%..............%.%
%.%.%%.%%  %%.%%.%.%
%......%G  G%......%
%.%.%%.%%%%%%.%%.%.%
%.%.......F......%.%
%.%%.%.%%%%%%.%.%%.%
%....%...P....%...o%
%%%%%%%%%%%%%%%%%%%%
