%%%%%%%%%%%%%%%%%%%%
%%%%%%%%%%%%%%%%%%%%
%.%...G...FF....%%%%
%.%.......FF....%%%%
%.%.......FF....%%%%
%.%.......FF....%%%%
%.%.......FF.G..%%%%
%.%....G..FF....%%%%
%.%.......FF....%%%%
%.%%.%.....%%.%.%%%%
%....%...P.....%...%
%%%%%%%%%%%%%%%%%%%%
