%%%%%%%%%%%%%%%%%%%%
%%%%%%%%%%%%%%%%%%%%
%.%...G...FF....%%%%
%.%.......FF....%%%%
%.%.......FF....%%%%
%.%.......FF....%%%%
%.%.......FF.G..%%%%
%.%.......FF....%%%%
%.%.......FF....%%%%
%.%%.%.....%%.%.%%%%
%....%...P.....%....
%%%%%%%%%%%%%%%%%%%%
