%%%%%%%%%%%%%%%%%%%%
%o...%.....F..%....%
%.%%.%.%%%%%%.%.%%.%
%...P.%..........%.%
%.%.%%%%%  %%.%%.%.%
%......%G  G%......%
%..%%%%%%%%%%%%%%%%%
%.%.......F......%.%
%%%%%%..%%%%%%%%%%%%
%....%........%...o%
%%%%%%%%%%%%%%%%%%%%
