%%%%%%%%%%%%%%%%%%%%
%G...%.....FF.%....%
%.%%.%.%%%%%%.%.%%.%
%.%..............%.%
%.%.%%.%%  %%.%%.%.%
%......%.  G%......%
%.%.%%.F%%%%%.%%.%.%
%.%..... .........%.
%.%%.%.%%%%%%.%.%%.%
%....%.G.P....%...o%
%o...%.....F..%....%
%%%%%%%%%%%%%%%%%%%%
