%%%%%%%%%%%%%%%%%%%%
%......%G  G%......%
%.%%...%%  %%...%%.%
%.%o.%......F.%.o%.%
%.%%.%.%%%%%%.%.%%.%
%........P..F......%
%%%%%%%%%%%%%%%%%%%%
