%%%%%%%%
%   P G%
%G%%F%%%
%...F  %
%%%%%%%%
