%%%%%%%%%%%%%%%%%%%%
%o...%........%...o%
%.%%.%.%%..%%.%.%%.%
%.%.....%..%.....%.%
%.%.%%.%%  %%.%%.%.%
%...... GGGG%.%....%
%.%....%%%%%%.%..%.%
%.%....%  oo%.%..%.%
%.%....% %%%%.%..%.%
%.%...........%..%.%
%.FF.%.%%%%%%.%.%%.%
%o...%...P....%...o%
%%%%%%%%%%%%%%%%%%%%
